9 6
#########
#.......#
#....|||#
#....|..#
#....|..#
#########

D1 T2 A2
##T#T#T##
A.......A
#.....D.#
#....D..#
#.......#
##A######